0,1,0,1,8,9,16,17,0,1
2,15,2,3,10,11,18,19,2,3
0,1,16,17,0,1,0,1,0,17
18,3,18,19,2,3,2,3,2,3
0,1,0,1,0,1,0,1,0,1
2,3,18,3,2,3,2,15,2,3
0,1,0,1,0,1,0,1,16,17
2,3,2,15,2,3,2,3,18,19
0,17,4,5,20,21,0,1,0,1
2,3,6,7,22,23,2,15,2,3
